ai = Anastasia Izmaylova <A.Izmaylova@cwi.nl>
ali = Ali Mesbah <>
anya = Anya Helene Bagge <anya@ii.uib.no>
arie = Arie van Deursen <>
asbin = Pierre-Etienne Moreau <>
basten = Bas Basten <basten@cwi.nl>
bertl = Bert Lisser <Bert.Lisser@cwi.nl>
bie = Pieter de Bie <>
bruntink = Magiel Bruntink <>
cdegouw = Stijn de Gouw <cdegouw@cwi.nl>
cleve = Anthony Cleve <>
cvs2svn = Gerco Ballintijn <>
darmo2 = Hayco de Jong <>
daybuild = Daily Build Bot <daybuild@cwi.nl>
dennish =  <>
derriks = Jan Derriks <>
economop = Rob Economopoulos <>
emilie = Emilie Balland <emilie.balland@gmail.com>
erik = Erik Post <>
eriks = Erik Scheffers <>
ernst = Ernst-Jan Verhoeven <>
evw = Erik van Wyk <>
gerco = Gerco Ballintijn <>
gipe = Jurgen Vinju <>
guyon = Julien Guyon <>
hidde = Hidde Baggelaar  <>
hills = Mark Hills <>
hills = Mark Hills <mhills@acm.org>
iversen = Jørgen Iversen <>
jbos = Jeroen van den Bos <jeroen@infuse.org>
jeldert = Jeldert Pol <>
jive = Jørgen Iversen <>
jkroon = Joppe Kroon <joppekroon@gmail.com>
jong = Hayco de Jong <>
js = Jeroen Scheerder <>
jurgenv = Jurgen J. Vinju <jurgen@vinju.org>
jvisser = Joost Visser <>
karltk = Karl Trygve Kalleberg <>
kooiker = Taeke Kooiker <>
kort = Jan Kort <>
kuipers = Tobias Kuipers <>
landman = Davy Landman <davy.landman@cwi.nl>
lankamp = Arnold Lankamp <arnold.lankamp@gmail.com>
leon = leon <leon@cwi.nl>
marangoz = Vania Marangozova <>
markvdb = Mark van den Brand <>
martinrw = Martin Bravenboer <>
mdejonge = Merijn de Jonge <>
michael = Michael Steindorfer <Michael.Steindorfer@cwi.nl>
migod = Michael Godfrey<migod@uwaterloo.ca>
moreau = Pierre-Etienne Moreau <>
oktener = Mehmet Oktener <>
olivierp = Pieter Olivier <>
paulk = Paul Klint <Paul.Klint@cwi.nl>
pemoreau = Pierre-Etienne Moreau <>
pgriffel = Paul Griffioen <Paul.Griffioen@cwi.nl>
ploeg = Atze van der Ploeg <A.J.van.der.Ploeg@cwi.nl>
prademak = Peter Rademaker <>
ralf = Ralf Lämmel <>
reilles = Antoine Reilles <>
rfuhrer = Robert M. Fuhrer <>
rozen = Riemer van Rozen <R.A.van.Rozen@cwi.nl>
sen1 = Jurgen Vinju <sen1@cwi.nl>
slinger = Slinger Jansen <>
stoel = Jouke Stoel <j.h.stoel@gmail.com>
storm = Tijs van der Storm <T.van.der.Storm@cwi.nl>
tonio = Antoine Reilles <>
toussain = Yoann Toussaint <>
uid504 = Daily Build System <daybuild@cwi.nl>
uid505 = Jørgen Iversen <>
uid506 = Taeke Kooiker <>
uid507 = Jurgen Vinju <jurgen@vinju.org>
uid508 = Hayco de Jong <>
uid509 = Mark van den Brand <>
uid512 = Vania Margangozova <>
uid514 = Tijs van der Storm <>
uid515 = Paul Klint <>
uid522 = Jørgen Iversen <>
uid567 = Tijs van der Storm <>
uid9485 = Jurgen Vinju <jurgen@vinju.org>
uid9907 = Jurgen Vinju <jurgen@vinju.org>
uid9908 = Jurgen Vinju <jurgen@vinju.org>
uid9910 = Taeke Kooiker <>
valkerin = Ron Valkering <>
valkerin = valkerin <valkerin@cwi.nl>
visser = Eelco Visser <>
visser = visser <visser@cwi.nl>
waruzjan = Waruzjan Shahbazian <>
wcook = William Cook <>
wietse  = Wietse Venema <wietsevenema@gmail.com>
zaytsev = Vadim Zaytsev <spider.vz@gmail.com>